{
    "Map1": [
        1, 1, 1, 1, 1, 0, 0,
        0, 0, 1, 1, 1, 0, 0,
        0, 0, 0, 0, 0, 0, 0,
        0, 0, 0, 0, 0, 0, 0, 
        0, 0, 0, 1, 1, 0, 0,
        0, 0, 0, 1, 1, 0, 0,  
        0, 0, 0, 1, 1, 0, 0 
    ],
    "Width1": 7,
    "Height1": 7,

    "Map2": [
        1, 1, 1, 1, 1, 1, 1,
        0, 1, 0, 0, 0, 1, 0,
        0, 0, 0, 0, 0, 0, 0,
        0, 0, 0, 0, 0, 0, 0, 
        0, 0, 0, 0, 0, 0, 0,
        0, 0, 0, 1, 0, 0, 0,  
        1, 1, 1, 1, 1, 1, 1 
    ],
    "Width2": 7,
    "Height2": 7,

    "Map3": [
        0, 0, 0, 0, 0, 0, 0,
        0, 0, 0, 0, 0, 0, 0,
        0, 0, 0, 0, 0, 0, 0,
        0, 0, 0, 0, 0, 0, 0, 
        0, 0, 0, 0, 0, 0, 0,
        0, 0, 0, 0, 0, 0, 0, 
        1, 1, 1, 1, 1, 1, 1 
    ],
    "Width3": 7,
    "Height3": 7,

    "Map4": [
        0, 0, 0, 0, 1, 0, 0,
        0, 0, 0, 0, 0, 0, 0,
        0, 0, 1, 0, 0, 0, 0,
        0, 0, 0, 0, 1, 0, 0, 
        1, 0, 1, 0, 1, 0, 0,
        0, 0, 0, 0, 0, 0, 1, 
        0, 1, 0, 1, 1, 0, 1 

    ],
    "Width4": 7,
    "Height4": 7

}
